Name: DesignedComponents:	System.Collections.Generic.List`1[ShipComponents]
Name: DesignedFighterComponents:	System.Collections.Generic.List`1[ShipComponents]
Name: UsedID:	System.Collections.Generic.List`1[System.Int32]
Name: IDComp:	System.Collections.Generic.Dictionary`2[System.Int32,ShipComponents]
Name: Obsolete:	False
Name: Name:	MilEngineMk2
Name: ID:	0
Name: Category:	ENGINE
Name: compClass:	SHIP
Name: Abilities:	System.Collections.Generic.List`1[Ability]
Name: Mass:	200
Name: CrewRequired:	50
Name: powerReq:	0
Name: ThermalSig:	0
Name: EMSig:	0
Name: Enabled:	True
Name: toggleable:	False
Name: Interior:	True

AbilityType:	THRUST
Rating:	6
Rating2:	1
Rating3:	1
thrust:	28
